{"level": 10,
    "size": [9,16],
    "start": [4,1],"end": [4,14],
    "box": {"symbol": "#","location": [[4,1]]},
    "tiles": {"floor": 1,"void": 0, "edge": 2, "teleport": 3},
    "teleports": {"tp1": [], "tp2": []},
  "maps": [
  [0,0,0,0,0,0,0,0,0,0,2,2,2,0,0,0],
  [0,0,0,0,0,0,0,0,0,0,2,1,2,0,0,0],
  [0,0,0,0,0,0,0,0,0,0,2,1,2,0,0,0],
  [2,2,2,2,2,2,0,0,0,0,2,1,1,2,2,2],
  [2,"#",1,1,1,2,2,2,2,1,1,1,1,1,0,2],
  [2,2,2,2,2,2,0,0,0,0,2,1,1,2,2,2],
  [0,0,0,0,0,0,0,0,0,0,2,1,2,0,0,0],
  [0,0,0,0,0,0,0,0,0,0,2,1,2,0,0,0],
  [0,0,0,0,0,0,0,0,0,0,2,2,2,0,0,0]
  ]
}