{"level": 10,
    "size": [9,16],
    "start": [4,1],"end": [4,14],
    "box": {"state": 2,"symbol": "#","location": [[4,1]]},
    "tiles": {"orange": 2,"floor": 1,"void": 0},
    "teleports": {"tp1": [], "tp2": []},
  "maps": [
  [0,0,0,0,0,0,0,0,0,0,1,1,1,0,0,0],
  [0,0,0,0,0,0,0,0,0,0,1,1,1,0,0,0],
  [0,0,0,0,0,0,0,0,0,0,1,1,1,0,0,0],
  [1,1,1,1,1,1,0,0,0,0,1,1,1,1,1,1],
  [1,"#",1,1,1,1,1,1,1,1,1,1,1,1,0,1],
  [1,1,1,1,1,1,0,0,0,0,1,1,1,1,1,1],
  [0,0,0,0,0,0,0,0,0,0,1,1,1,0,0,0],
  [0,0,0,0,0,0,0,0,0,0,1,1,1,0,0,0],
  [0,0,0,0,0,0,0,0,0,0,1,1,1,0,0,0]
  ]
}