{"level": 16,
    "size": [10,15],
    "start": [1,13],"end": [8,1],
    "box": {"state": 2,"symbol": "#","location": [[1,13]]},
    "tiles": {"floor": 1,"void": 0, "edge": 2, "teleport": 3},
    "teleports": {"tp1": [], "tp2": []},
  "maps": [
  [0,0,0,0,0,0,0,0,0,0,0,2,2,2,2],
  [0,2,2,2,2,2,2,2,2,2,2,2,1,"#",2],
  [0,2,1,1,1,1,1,1,1,1,1,0,1,2,0],
  [0,2,1,1,1,1,1,1,1,1,0,1,1,2,0],
  [0,2,2,2,1,0,0,1,1,1,1,0,1,2,2],
  [0,0,0,2,2,2,2,2,2,2,2,0,1,0,2],
  [0,0,0,0,0,0,0,0,0,0,2,0,1,1,2],
  [2,2,2,0,0,0,0,0,0,0,2,1,2,2,2],
  [2,0,1,2,2,2,2,2,2,2,2,2,2,0,0],
  [2,2,2,2,0,0,0,0,0,0,0,0,0,0,0]
  ]
}