{"level": 5,
    "size": [9,14],
    "start": [5,1],"end": [7,6],
    "box": {"state": 2,"symbol": "#","location": [[5,1]]},
    "tiles": {"orange": 2,"floor": 1,"void": 0},
  "maps": [
  [0,0,0,2,2,2,2,2,2,2,0,0,0,0],
  [0,0,0,2,2,2,2,2,2,2,0,0,0,0],
  [1,1,1,1,0,0,0,0,0,1,1,1,0,0],
  [1,1,1,0,0,0,0,0,0,0,1,1,0,0],
  [1,1,1,0,0,0,0,0,0,0,1,1,0,0],
  [1,"#",1,0,0,1,1,1,1,2,2,2,2,2],
  [1,1,1,0,0,1,1,1,1,2,2,2,2,2],
  [0,0,0,0,0,1,0,1,0,0,2,2,1,2],
  [0,0,0,0,0,1,1,1,0,0,2,2,2,2]
  ]
}