{"level": 4,
    "size": [10,15],
    "start": [1,13],"end": [8,1],
    "box": {"state": 2,"symbol": "#","location": [[1,13]]},
    "tiles": {"orange": 2,"floor": 1,"void": 0},
  "maps": [
  [0,0,0,0,0,0,0,0,0,0,0,1,1,1,1],
  [0,1,1,1,1,1,1,1,"q1",1,1,1,1,"#",1],
  [0,1,1,1,1,0,0,0,0,0,0,0,1,1,1],
  [0,1,1,1,1,0,0,0,0,0,0,0,0,0,0],
  [0,1,1,1,1,0,0,0,0,0,0,0,0,0,0],
  [0,0,0,1,1,1,1,1,1,1,1,1,1,0,0],
  [0,0,0,0,0,0,0,0,0,0,1,1,1,1,1],
  [1,1,1,0,0,0,0,0,0,0,1,1,1,1,1],
  [1,0,1,1,1,0,0,1,1,1,1,1,1,0,0],
  [1,1,1,1,0,0,0,0,0,0,0,0,0,0,0]
  ]
}