{"level": 8,
    "size": [10,15],
    "start": [3,0],"end": [4,13],
    "box": {"symbol": "#","location": [[3,0]]},
    "tiles": {"floor": 1,"void": 0, "edge": 2, "teleport": 3},
    "teleports": {"tp1": [], "tp2": []},
  "maps": [
  [0,0,0,0,0,2,2,2,2,2,2,0,0,0,0],
  [0,0,0,0,0,2,0,0,2,1,2,0,0,0,0],
  [0,0,0,0,0,2,0,0,2,2,2,2,2,0,0],
  ["#",2,2,2,1,2,0,0,0,0,0,2,2,2,2],
  [0,0,0,0,2,1,2,0,0,0,0,2,1,0,2],
  [0,0,0,0,2,2,2,0,0,0,0,0,2,2,2],
  [0,0,0,0,0,0,2,0,0,2,2,0,0,0,0],
  [0,0,0,0,0,0,2,2,2,1,2,0,0,0,0],
  [0,0,0,0,0,0,2,1,1,1,2,0,0,0,0],
  [0,0,0,0,0,0,0,2,2,2,0,0,0,0,0]
  ]
}