{"level": 8,
    "size": [10,15],
    "start": [3,0],"end": [4,13],
    "box": {"state": 2,"symbol": "#","location": [[3,0]]},
    "tiles": {"orange": 2,"floor": 1,"void": 0},
  "maps": [
  [0,0,0,0,0,1,1,1,1,1,1,0,0,0,0],
  [0,0,0,0,0,1,0,0,1,1,1,0,0,0,0],
  [0,0,0,0,0,1,0,0,1,1,1,1,1,0,0],
  ["#",1,1,1,1,1,0,0,0,0,0,1,1,1,1],
  [0,0,0,0,1,1,1,0,0,0,0,1,1,0,1],
  [0,0,0,0,1,1,1,0,0,0,0,0,1,1,1],
  [0,0,0,0,0,0,1,0,0,1,1,0,0,0,0],
  [0,0,0,0,0,0,1,1,1,1,1,0,0,0,0],
  [0,0,0,0,0,0,1,1,1,1,1,0,0,0,0],
  [0,0,0,0,0,0,0,1,1,1,0,0,0,0,0]
  ]
}